{
  start: { x: 683, y: 490 },
  ends: [
    { x: 1048, y: 510 },
    { x: 1048, y: 450 },
    { x: 1048, y: 390 },
    { x: 988, y: 510 },
    { x: 988, y: 450 },
    { x: 988, y: 390 },
  ],
  walls: [
    { x: 250, y: 10 },
    { x: 250, y: 70 },
    { x: 250, y: 130 },
    { x: 250, y: 190 },
    { x: 190, y: 190 },
    { x: 130, y: 190 },
    { x: 130, y: 250 },
    { x: 130, y: 310 },
    { x: 70, y: 310 },
    { x: 10, y: 310 },
    { x: 10, y: 370 },
    { x: 10, y: 430 },
    { x: 10, y: 490 },
    { x: 70, y: 490 },
    { x: 130, y: 490 },
    { x: 190, y: 490 },
    { x: 250, y: 490 },
    { x: 250, y: 550 },
    { x: 250, y: 610 },
    { x: 310, y: 610 },
    { x: 370, y: 610 },
    { x: 370, y: 490 },
    { x: 430, y: 610 },
    { x: 430, y: 490 },
    { x: 430, y: 370 },
    { x: 370, y: 370 },
    { x: 250, y: 370 },
    { x: 250, y: 310 },
    { x: 430, y: 310 },
    { x: 370, y: 310 },
    { x: 490, y: 610 },
    { x: 490, y: 490 },
    { x: 550, y: 610 },
    { x: 610, y: 610 },
    { x: 610, y: 550 },
    { x: 610, y: 490 },
    { x: 670, y: 550 },
    { x: 730, y: 550 },
    { x: 730, y: 490 },
    { x: 790, y: 550 },
    { x: 790, y: 490 },
    { x: 850, y: 550 },
    { x: 910, y: 550 },
    { x: 970, y: 550 },
    { x: 1030, y: 550 },
    { x: 1090, y: 550 },
    { x: 1090, y: 490 },
    { x: 1090, y: 430 },
    { x: 1090, y: 370 },
    { x: 1090, y: 310 },
    { x: 1030, y: 310 },
    { x: 970, y: 310 },
    { x: 910, y: 310 },
    { x: 850, y: 310 },
    { x: 790, y: 310 },
    { x: 790, y: 370 },
    { x: 730, y: 370 },
    { x: 670, y: 370 },
    { x: 610, y: 370 },
    { x: 550, y: 370 },
    { x: 550, y: 310 },
    { x: 550, y: 250 },
    { x: 550, y: 190 },
    { x: 490, y: 190 },
    { x: 490, y: 130 },
    { x: 490, y: 70 },
    { x: 490, y: 10 },
    { x: 430, y: 10 },
    { x: 370, y: 10 },
    { x: 310, y: 10 },
  ],
  boxes: [
    { x: 130, y: 430 },
    { x: 310, y: 430 },
    { x: 310, y: 250 },
    { x: 310, y: 130 },
    { x: 430, y: 250 },
    { x: 430, y: 190 },
  ]
}
